#,#,#,#,#,#,#,#,#,#,#,#,#,#,#
#,L, , , , , , , , , , ,#,W,#
#,#,#,#,#,#,#,#, ,@, , ,#,#,#
#,L,#, , , , , , ,I, , , ,#,#
#, ,#, , , , , , , , , , ,#,#
#, ,#, ,C, , , , ,I, ,T, ,#,#
#, ,#, , , , , , , , , , ,#,#
#, ,#, , , , , , , , , , ,#,#
#, ,#,#,#,#,#,#,#, , , ,#,#,#
#, , , , , , , , , , , ,#,W,#
#,#,#,#,#,#,#,#,#,#,#,#,#,#,#
