#,#,#,#,#,#,#,#,#,#,#,#,#,#,#,#
#, , , , , , , , , , , , ,#,#,#
#, ,#,I,#,#,#,#,#,#,#, , , , ,#
#, ,#, , ,#, , , , ,#, , , , ,#
#, ,#, , ,#, ,@, , ,#, , , , ,#
#, ,#,T, ,#, , , , ,#, , , , ,#
#, ,#,#,#,#, ,I, , ,#,#,#,I,#,#
#, ,#,L, ,#, , , , , , , , , ,#
#, ,#,#, ,#,#,#,#,#,#,#,#,#, ,#
#, , , , , , , , , , , , ,#,L,#
#,#,#,#,#,#,#,#,#,#,#,#,#,#,#,#
