#,#,#,#,#,#,#,#,#,#,#,#,#,#,#,#
#, , , , , , , , , , , , , , ,#
#, ,#,#,#,#,#, , ,#,#,#,#,#, ,#
#, , , , ,L,I, , ,I,L, , , , ,#
#,#,I,#,#,#,#, , ,#,#,#,#,I,#,#
#, , ,#,#,#,#, , ,#,#,#,#, , ,#
#,C, ,#, , ,#,@, ,#, , ,#, ,T,#
#,#,#,#, ,I, , , , ,I, ,#,#,#,#
#, , ,#, , , , , , , , ,#, , ,#
#,W, ,#, , , , , , , , ,#, ,W,#
#,#,#,#,#,#,#,#,#,#,#,#,#,#,#,#
