#,#,#,#,#,#,#,#,#,#,#,#,#,#,#,#
#,C, , , , , , ,C,#, , , ,#,L,#
#, , , , , , , , ,#, ,#, ,#,L,#
#, , , , , ,I, , ,#, ,#, ,#,L,#
#, , , , , , , , ,#, ,#, ,#,L,#
#,T, , ,I, ,@, ,M, , ,#, ,#,L,#
#, , , , , , , , ,#,#,#, ,#,L,#
#, , , , , ,I, , ,#, , , ,#,M,#
#, , , , , , , , ,#, ,#,#,#, ,#
#,C, , , , , , ,C,#, , , , , ,#
#,#,#,#,#,#,#,#,#,#,#,#,#,#,#,#
