#,#,#,#,#,#,#,#,#,#,#,#,#,#,#,#
#, , , , , , , , , , , , , ,W,#
#, , , , , , , , , , , ,T, , ,#
#, , , , , , , , , , , , , , ,#
#, , , , , , , , , , , , , , ,#
#, , , , , , , , , , , , , , ,#
#, , , , , , , , , , , , , , ,#
#, , , , , , , , , , , , , , ,#
#, , ,@, , , , , , , , , , , ,#
#,L, , , , , , , , , , , , , ,#
#,#,#,#,#,#,#,#,#,#,#,#,#,#,#,#
