#,#,#,#,#,#,#,#,#,#,#,#,#,#,#,#
#, ,#,L,L,L,L,L,L,L,L,L,L,#, ,#
#, ,#,L,L,L,L,C,C,L,L,L,L,#, ,#
#, ,#,L,L,I,I,I,I,I,I,L,L,#, ,#
#, ,#,L,L,I, , , , ,I,L,L,#, ,#
#,W,#,L,C,I, ,@,T, ,I,C,L,#,W,#
#, ,#,L,L,I, , , , ,I,L,L,#, ,#
#, ,#,L,L,I,I,I,I,I,I,L,L,#, ,#
#, ,#,L,L,L,L,C,C,L,L,L,L,#, ,#
#, ,#,L,L,L,L,L,L,L,L,L,L,#, ,#
#,#,#,#,#,#,#,#,#,#,#,#,#,#,#,#
