#,#,#,#,#,#,#,#,#,#,#,#,#,#,#,#
#, , , , , , ,#,M, , , , , ,M,#
#, , , , , , ,#, , , , , , , ,#
#, , , ,T, , ,#, , , , , ,#,32,#
#, , , , , ,#,L,#, , , , ,#,L,#
#, ,I, ,@, ,15,15,15, , , ,B, ,34,#
#, , , , , ,#,W,#, , , , ,#,W,#
#, , , , , , ,11,#, , , , ,#,#,#
#, , , , , , , ,#, , , , ,40,L,#
#, , , , , , ,#,#,M, , , ,40,L,#
#,#,#,#,#,#,#,#,#,#,#,#,#,#,#,#
