#,#,#,#,#,#,#,#,#,#,#,#,#,#,#,#
#, , , , , , , , , , , , , , ,#
#, ,#,#,#,#,#, , ,#,#,#,#,#, ,#
#, , , , ,L,I, , ,I,L, , , , ,#
#,#,I,#,#,#,#, , ,#,#,#,#,I,#,#
#, , ,#,#,#,#, , ,#,#,#,#, , ,#
#,I, ,#, , ,#,@, ,#, , ,#, ,T,#
#,#,#,#, ,I, , , , ,I, ,#,#,#,#
#, , ,#, , , , , , , , ,#, , ,#
#,W, ,#, , , , , , , , ,#, ,W,#
#,#,#,#,#,#,#,#,#,#,#,#,#,#,#,#
