#,#,#,#,#,#,#,#,#,#,#,#,#,#,#,#
#, ,#,L,L,L,L,L,L,L,L,L,L,#, ,#
#, ,#,L,L,L,L,M,M,L,L,L,L,#, ,#
#, ,#,L,L,I,I,I,I,I,I,L,L,#, ,#
#, ,#,L,L,I, , , , ,I,L,L,#, ,#
#,W,#,L,M,I, ,@,T, ,I,M,L,#,W,#
#, ,#,L,L,I, , , , ,I,L,L,#, ,#
#, ,#,L,L,I,I,I,I,I,I,L,L,#, ,#
#, ,#,L,L,L,L,M,M,L,L,L,L,#, ,#
#, ,#,L,L,L,L,L,L,L,L,L,L,#, ,#
#,#,#,#,#,#,#,#,#,#,#,#,#,#,#,#
