#,#,#,#,#,#,#,#,#,#,#,#,#,#,#,#
#, , , ,#, , , , , , , ,#,W,#,#
#, ,T, ,#, , , , , ,I, ,#,13,#,#
#, , , ,#, , , , , , , , , , ,#
#, ,#,#,#,#,M, , , , , , , , ,#
#, ,34,L,28, , , ,28, , ,@, , , ,#
#, ,#,#,#,#,M, , , , , , , , ,#
#, , , ,#, , , , , , , , , , ,#
#, , , ,34, , , , , ,I, , , , ,#
#, , , ,#, , , , , , , , , , ,#
#,#,#,#,#,#,#,#,#,#,#,#,#,#,#,#
