#,#,#,#,#,#,#,#,#,#,#,#,#,#,#,#
#,L, , , ,#,W,W,#, , , , , ,M,#
#, , , , ,#,#,#,#, , , , , , ,#
#, , , , , , , , , , ,I, , , ,#
#,#,#,#,#,#,#,#,#, , , ,@, , ,#
#,L,L, , , , , , , , ,I, , ,T,#
#,#,#,#,#,#,#,#,#, , , , , , ,#
#, , , , , , , , , , ,I, , , ,#
#, ,#,#,#,#,#,#,#, , , , , , ,#
#, , , , , , ,L,#, , , , , ,M,#
#,#,#,#,#,#,#,#,#,#,#,#,#,#,#,#
