#,#,#,#,#,#,#,#,#,#,#,#,#,#,#,#
#,L, , , ,#,W,W,#, , , , , ,C,#
#, , , , ,#,#,#,#, , , , , , ,#
#, , , , , , , , , , ,I, , , ,#
#,#,#,#,#,#,#,#,#, , , ,@, , ,#
#,L,L, , , , , , , , ,I, , ,T,#
#,#,#,#,#,#,#,#,#, , , , , , ,#
#, , , , , , , , , , ,I, , , ,#
#, ,#,#,#,#,#,#,#, , , , , , ,#
#, , , , , , ,L,#, , , , , ,C,#
#,#,#,#,#,#,#,#,#,#,#,#,#,#,#,#
