#,#,#,#,#,#,#,#,#,#,#,#,#,#,#,#
#,L, , ,#, , , , , , , , ,T, ,#
#,L, , ,#,#, , , , , , , , , ,#
#,L, , , , , , , , , , ,#,#,#,#
#,L, , ,#,#, , , , ,I, , , , ,#
#,L, , ,#, , , , , , , ,#,#, ,#
#,L, , ,#, ,I, , , , , , ,#, ,#
#,L, , ,#, , , , , , , , ,#, ,#
#,L, , ,#, ,@, , , , , , ,#, ,#
#,L, , ,#, , , , , , , , ,#,L,#
#,#,#,#,#,#,#,#,#,#,#,#,#,#,#,#
