#,#,#,#,#,#,#,#,#,#
#, , , ,#, , , , ,#
#, ,@, ,#,W,W, , ,#
#, , , ,#,W,W, , ,#
#,I,I, , , , , , ,#
#,1,2,3, , , , , ,#
#, , , , , , , , ,#
#, ,L, , , , , ,T,#
#,#,#,#,#,#,#,#,#,#