#,#,#,#,#,#,#,#,#,#,#,#,#,#,#,#
#,W,#, , , , , , , , , , ,#,M,#
#,#,#, , , , , , , , , , ,#,50,#
#, , , , , , , , , , , , , , ,#
#, , , , , ,#,14,#,24,#,46,#, , ,#
#, ,@, ,I, ,#,L,#,L,#,L,#, ,T,#
#, , , , , ,#,12,#,26,#,48,#, , ,#
#, , , , , , , , , , , , , , ,#
#,#,#, , , , , , , , , , ,#,50,#
#,W,#, , , , , , , , , , ,#,M,#
#,#,#,#,#,#,#,#,#,#,#,#,#,#,#,#
