#,#,#,#,#,#,#,#,#,#
#, , , ,#, , , , ,#
#, ,@, ,#, , ,W, ,#
#, , , ,#, , , , ,#
#,I,I, , , , , , ,#
#,1,2,5, , , , , ,#
#, , , , , , , , ,#
#,L, , , , , , ,T,#
#,#,#,#,#,#,#,#,#,#