#,#,#,#,#,#,#,#,#,#,#,#,#,#,#,#
#,L,50, , , , , , , , , , ,50,L,#
#,50, , , , , , , , , , , , ,50,#
#, , , , ,I, ,I, ,I, , , , , ,#
#, , , ,I, , , , , ,I, , , , ,#
#, , , , , , ,@, , , , , , , ,#
#, , , ,I, , , , , ,I, , , , ,#
#, , , , , ,#,64,#, , , , , , ,#
#,50, , , , ,#,T,#, , , , , ,50,#
#,L,50, , , ,#,#,#, , , , ,50,L,#
#,#,#,#,#,#,#,#,#,#,#,#,#,#,#,#
