#,#,#,#,#,#,#,#,#,#,#,#,#,#,#,#
#, , , , , , ,T, , , , , , , ,#
#, ,C, , , , , , , , , , , , ,#
#, , , , , , , , , , , , , , ,#
#, , , , , , ,I, , , , , , , ,#
#, ,@, , , ,I,W,I, , , , , ,L,#
#, , , , , , ,I, , , , , , , ,#
#, , , , , , , , , , , , , , ,#
#, ,C, , , , , , , , , , , , ,#
#, , , , , , , , , , , , , , ,#
#,#,#,#,#,#,#,#,#,#,#,#,#,#,#,#
