#,#,#,#,#,#,#,#,#,#,#,#,#,#,#,#
#, , , , , , , , ,#,#,#,#,#,#,#
#, ,@, , , , , , , , , , , ,T,#
#, , , , , , , , ,#,#,#,#,#,#,#
#, , , , , , , , ,#, , , , , ,#
#,#, , , , , , , ,#, , ,L, , ,#
#,#,#, ,L, , , , ,#, , , , , ,#
#,#,#,#,#,#,#,#,#,#,#,#,#,#,#,#
