#,#,#,#,#,#,#,#,#,#,#,#,#,#,#,#
#,W, ,#, , , , , , , , , , , ,#
#, , ,#, , , , ,I, , , , ,C, ,#
#,#,#,#, , , , , , , , , , , ,#
#, , , , , ,#,#,#,#,#, , ,#,#,#
#, ,T, ,@, ,30,L,#,L,14, , ,#,#,#
#, , , , , ,#,#,#,#,#, , ,#,#,#
#,#,#,#, , , , , , , , , , , ,#
#, , ,#, , , , ,I, , , , ,C, ,#
#,W, ,#, , , , , , , , , , , ,#
#,#,#,#,#,#,#,#,#,#,#,#,#,#,#,#
