#,#,#,#,#,#,#,#,#,#,#,#,#,#,#
#,M,32, , , , , , , , , ,32,T,#
#,#,#, ,@, , , , , ,I, ,#,#,#
#, ,#, , , ,#,32,#, , , ,#, ,#
#, ,#, , ,#,#,W,#,#, , ,#, ,#
#, ,#, , ,32,W,L,W,32, , ,#, ,#
#, ,#, , ,#,#,W,#,#, , ,#, ,#
#, ,#, , , ,#,32,#, , , ,#, ,#
#, ,#, ,I, , , , , , , ,#, ,#
#,W,#, , , , , , , , , ,#,W,#
#,#,#,#,#,#,#,#,#,#,#,#,#,#,#
