#,#,#,#,#,#,#,#,#,#,#,#,#,#,#
#,C,32, , , , , , , , , ,32,T,#
#,#,#, ,@, , , , , ,I, ,#,#,#
#, ,#, , , ,#,32,#, , , ,#, ,#
#, ,#, , ,#,#,M,#,#, , ,#, ,#
#, ,#, , ,32,M,L,M,32, , ,#, ,#
#, ,#, , ,#,#,M,#,#, , ,#, ,#
#, ,#, , , ,#,32,#, , , ,#, ,#
#, ,#, ,I, , , , , , , ,#, ,#
#,W,#, , , , , , , , , ,#,W,#
#,#,#,#,#,#,#,#,#,#,#,#,#,#,#
