#,#,#,#,#,#,#,#,#,#,#,#,#,#,#,#
#, , , , , , ,T, , , , , , , ,#
#, ,M, , , , , , , , , , , , ,#
#, , , , , , , , , , , , , , ,#
#, , , , , , ,I, , , , , , , ,#
#, ,@, , , ,I,W,I, , , , , ,L,#
#, , , , , , ,I, , , , , , , ,#
#, , , , , , , , , , , , , , ,#
#, ,M, , , , , , , , , , , , ,#
#, , , , , , , , , , , , , , ,#
#,#,#,#,#,#,#,#,#,#,#,#,#,#,#,#
