#,#,#,#,#,#,#,#,#,#,#,#,#,#,#,#
#, , , , , , ,#,C, , , , , ,C,#
#, , , , , , ,#, , , , , , , ,#
#, , , ,T, , ,#, , , , , ,#,32,#
#, , , , , ,#,L,#, , , , ,#,L,#
#, ,I, ,@, ,15,15,15, , , ,B, ,34,#
#, , , , , ,#,W,#, , , , ,#,W,#
#, , , , , , ,11,#, , , , ,#,#,#
#, , , , , , , ,#, , , , ,40,L,#
#, , , , , , ,#,#,C, , , ,40,L,#
#,#,#,#,#,#,#,#,#,#,#,#,#,#,#,#
