#,#,#,#,#,#,#,#,#,#,#,#,#,#,#,#
#, , , , , , , , , , ,L, , , ,#
#, , , , , , ,#,#,#,#,#,#,#,#,#
#, , , , , , , , , , , , ,#,T,#
#, , , , , , , , , , , , , , ,#
#, , , , , , , , , , , , , , ,#
#, , , , , ,I, , , , , , , , ,#
#, , , ,#,#,W,#,#, , , , , , ,#
#, ,@, ,#,W,W,W,#, , , , , , ,#
#, , , ,#,W,W,W,#, , , , , , ,#
#,#,#,#,#,#,#,#,#,#,#,#,#,#,#,#
