#,#,#,#,#,#,#,#,#,#,#,#,#,#,#,#
#,W, ,#, , , , , , , , , , , ,#
#, , ,#, , , , ,I, , , , ,M, ,#
#,#,#,#, , , , , , , , , , , ,#
#, , , , , ,#,#,#,#,#, , ,#,#,#
#, ,T, ,@, ,30,L,#,L,14, , ,#,#,#
#, , , , , ,#,#,#,#,#, , ,#,#,#
#,#,#,#, , , , , , , , , , , ,#
#, , ,#, , , , ,I, , , , ,M, ,#
#,W, ,#, , , , , , , , , , , ,#
#,#,#,#,#,#,#,#,#,#,#,#,#,#,#,#
