#,#,#,#,#,#,#,#,#,#,#,#,#,#,#,#
#, , , ,#, , , , , , , ,#,W,#,#
#, ,T, ,#, , , , , ,I, ,#,13,#,#
#, , , ,#, , , , , , , , , , ,#
#, ,#,#,#,#,W, , , , , , , , ,#
#, ,34,L,28, , , ,28, , ,@, , , ,#
#, ,#,#,#,#,W, , , , , , , , ,#
#, , , ,#, , , , , , , , , , ,#
#, , , ,34, , , , , ,I, , , , ,#
#, , , ,#, , , , , , , , , , ,#
#,#,#,#,#,#,#,#,#,#,#,#,#,#,#,#
