#,#,#,#,#,#,#,#,#,#,#,#,#,#,#,#
#,M, , , , , , ,M,#, , , ,#,L,#
#, , , , , , , , ,#, ,#, ,#,L,#
#, , , , , ,I, , ,#, ,#, ,#,L,#
#, , , , , , , , ,#, ,#, ,#,L,#
#,T, , ,I, ,@, ,W, , ,#, ,#,L,#
#, , , , , , , , ,#,#,#, ,#,L,#
#, , , , , ,I, , ,#, , , ,#,W,#
#, , , , , , , , ,#, ,#,#,#, ,#
#,M, , , , , , ,M,#, , , , , ,#
#,#,#,#,#,#,#,#,#,#,#,#,#,#,#,#
